3    N  K
47   A  S  
48   Y  F  
60   A  T  
24   L  I  
52   A  T  
54   Q  T  
99   C  R  
102  S  G  
104  F  Y  
142  S  P  
143  S  E  
144  Q  H  
74   A  G  
177  Q  H  
178  A  T  
139  L  F  
181  S  R  
173  H  R
