4    R  S  
47   A  S  
48   Y  F  
60   A  T  
24   L  I  
52   A  T  
54   Q  T  
87   T  K  
99   C  R  
102  S  G  
104  F  Y  
107  S  N  
142  S  P  
143  S  E  
144  Q  H  
148  E  D  
177  Q  H  
178  A  T  
139  L  F  
181  S  R  
