3    N  K
24   L  I  
54   Q  T  
102  S  G  
74   A  G  
177  Q  H  
178  A  T  
173  H  R

